# # # # # # # # # # # # # # # # # # # 
# S # # # # # # # # # # # E     # # # 
#   # # # # # # # # # # # # #   # # # 
#   # # # # # # # # # # # #     # # # 
#         # # # # # # # #     # # # # 
#   # #   # # # # # # # #   # # # # # 
#   # #   # # # # # # # #   # # # # # 
#   # # # # # # # # # # #   # # # # # 
#                                     
# # # # # # # # # # # # # # # # # # # 